gene 	sequence	type
ATP6V1C1	GTCTCGTGGGCTCGGAGATGTGTATAAGAGACAGTGTGCACAAAAGCCCTGTTCA	TAP-control-inner
AZIN1	GTCTCGTGGGCTCGGAGATGTGTATAAGAGACAGGGTGCAACTTTGAGTCCTTGGC	TAP-control-inner
CCNE2	GTCTCGTGGGCTCGGAGATGTGTATAAGAGACAGGGAAAGATGGACTGCTGAGCC	TAP-control-inner
COPB1	GTCTCGTGGGCTCGGAGATGTGTATAAGAGACAGTGCTGCTGTTACCGGCCATA	TAP-control-inner
CTR9	GTCTCGTGGGCTCGGAGATGTGTATAAGAGACAGAAGGTTTGACTGAAACTGTGGCA	TAP-control-inner
EBAG9	GTCTCGTGGGCTCGGAGATGTGTATAAGAGACAGTCAGTACCTCTCAAGCTAGTGT	TAP-control-inner
EIF3F	GTCTCGTGGGCTCGGAGATGTGTATAAGAGACAGACCTGGCCAACCTCACACAG	TAP-control-inner
EMC2	GTCTCGTGGGCTCGGAGATGTGTATAAGAGACAGGGGGAGATGGGGGAAATCCAT	TAP-control-inner
GTF2H1	GTCTCGTGGGCTCGGAGATGTGTATAAGAGACAGACATCTGCTCCACGCCAACT	TAP-control-inner
HBD	GTCTCGTGGGCTCGGAGATGTGTATAAGAGACAGGGCAAGAAGGTGCTAGGTGC	TAP-control-inner
HTATIP2	GTCTCGTGGGCTCGGAGATGTGTATAAGAGACAGCCTGATGCCACTGGTTCCGA	TAP-control-inner
ILK	GTCTCGTGGGCTCGGAGATGTGTATAAGAGACAGTGGTTGGGGGAATGCACCTC	TAP-control-inner
INTS8	GTCTCGTGGGCTCGGAGATGTGTATAAGAGACAGATTGCAATCAAAGCCATCGGC	TAP-control-inner
MRPL17	GTCTCGTGGGCTCGGAGATGTGTATAAGAGACAGATCGGAGTTTGGATCGGGCC	TAP-control-inner
MTDH	GTCTCGTGGGCTCGGAGATGTGTATAAGAGACAGATGTGGCGCCAAGAACGAAC	TAP-control-inner
NAP1L4	GTCTCGTGGGCTCGGAGATGTGTATAAGAGACAGGGTTTGGTGTGACCGCTTGG	TAP-control-inner
NSMCE2	GTCTCGTGGGCTCGGAGATGTGTATAAGAGACAGCCAGCAGCCTACCTCCTACC	TAP-control-inner
NUDCD1	GTCTCGTGGGCTCGGAGATGTGTATAAGAGACAGTGGCCTCTTTGTACTGGAAAAGT	TAP-control-inner
ACP5	GTCTCGTGGGCTCGGAGATGTGTATAAGAGACAGGCTGAGTTCCGGGGTGCAAT	Cell-state-inner
ASCL2	GTCTCGTGGGCTCGGAGATGTGTATAAGAGACAGGTGGAAACGGGCTTGGAGCT	Cell-state-inner
CA1	GTCTCGTGGGCTCGGAGATGTGTATAAGAGACAGAGCAAGACAGCATGCCTTCAA	Cell-state-inner
CCNB1	GTCTCGTGGGCTCGGAGATGTGTATAAGAGACAGTCTTCCAGTTATGCAGCACCTGG	Cell-state-inner
CCNB2	GTCTCGTGGGCTCGGAGATGTGTATAAGAGACAGAGACCTTGCCTCCCCACTGAT	Cell-state-inner
CD320	GTCTCGTGGGCTCGGAGATGTGTATAAGAGACAGCCACGTGGAACCTCGAACCC	Cell-state-inner
CDC20	GTCTCGTGGGCTCGGAGATGTGTATAAGAGACAGTCACACATCCCGGGTCCTGA	Cell-state-inner
CDKN3	GTCTCGTGGGCTCGGAGATGTGTATAAGAGACAGAGCCATAGACAGCCTGCGAG	Cell-state-inner
DDIT3	GTCTCGTGGGCTCGGAGATGTGTATAAGAGACAGTCCCACATACGCAGGGGGAA	Cell-state-inner
HRAS	GTCTCGTGGGCTCGGAGATGTGTATAAGAGACAGACTGTGGAATCTCGGCAGGC	Cell-state-inner
NQO2	GTCTCGTGGGCTCGGAGATGTGTATAAGAGACAGCCACTGGCACTTCGGGCAAT	Cell-state-inner
PNRC1	GTCTCGTGGGCTCGGAGATGTGTATAAGAGACAGATTTTGCCCTGCCCACATTGC	Cell-state-inner
PPP1R15A	GTCTCGTGGGCTCGGAGATGTGTATAAGAGACAGGGTGAGCGAGAGGCAACCAG	Cell-state-inner
SAT1	GTCTCGTGGGCTCGGAGATGTGTATAAGAGACAGGAGGAGTGAGGAGTGCTGCTG	Cell-state-inner
STX3	GTCTCGTGGGCTCGGAGATGTGTATAAGAGACAGCTGCTGGTCTCTGGCAGTCT	Cell-state-inner
WDR77	GTCTCGTGGGCTCGGAGATGTGTATAAGAGACAGCCCCCTGGCTCCCTAGTGAT	Cell-state-inner
ANAPC11_I	GTCTCGTGGGCTCGGAGATGTGTATAAGAGACAGCCAGCCTGGTCATGCCTGTC	P2-inner
ATF2_I	GTCTCGTGGGCTCGGAGATGTGTATAAGAGACAGACGGTTAACAAGCTTACCAAGGT	P2-inner
BUB1B_I	GTCTCGTGGGCTCGGAGATGTGTATAAGAGACAGACAGATTGCTGCCTCAGAGCA	P2-inner
CFL1_I	GTCTCGTGGGCTCGGAGATGTGTATAAGAGACAGATCCCCATTCCCCACCTGGT	P2-inner
EYA3_I	GTCTCGTGGGCTCGGAGATGTGTATAAGAGACAGGGAGCCCTCCCATTAAGGACG	P2-inner
FKBP2_I	GTCTCGTGGGCTCGGAGATGTGTATAAGAGACAGGCTGGTGATCCCATCCGAGC	P2-inner
GPBP1_I	GTCTCGTGGGCTCGGAGATGTGTATAAGAGACAGCAGATGACGACGATGTGTGAAGGA	P2-inner
HSP90B1_I	GTCTCGTGGGCTCGGAGATGTGTATAAGAGACAGACCCTTGTTGGTGATGGAGAGTT	P2-inner
HSPA5_I	GTCTCGTGGGCTCGGAGATGTGTATAAGAGACAGCTCCTGCTCCTCGTGGGGTC	P2-inner
KNOP1_I	GTCTCGTGGGCTCGGAGATGTGTATAAGAGACAGGCGGAAGAGCCCCAGAGAAC	P2-inner
MKRN1_I	GTCTCGTGGGCTCGGAGATGTGTATAAGAGACAGTTGCCTCATTCCACCCCTGAG	P2-inner
MRPL17_I	GTCTCGTGGGCTCGGAGATGTGTATAAGAGACAGAACCAGCTGCTGCAGGGTTT	P2-inner
MRPS25_I	GTCTCGTGGGCTCGGAGATGTGTATAAGAGACAGGGCTGGGGTGATGGTGTCTG	P2-inner
NOSIP_I	GTCTCGTGGGCTCGGAGATGTGTATAAGAGACAGGGGAAGGGACCACTCGGGAA	P2-inner
NUP43_I	GTCTCGTGGGCTCGGAGATGTGTATAAGAGACAGTGGCAGGGTTTTAGTGTGTGAGT	P2-inner
ZNF317_I	GTCTCGTGGGCTCGGAGATGTGTATAAGAGACAGTGTCACCACATGGGCTTCTGA	P2-inner
MYC_TAP_inner	GTCTCGTGGGCTCGGAGATGTGTATAAGAGACAGAGCTACGGAACTCTTGTGCGT	MYC inner primer from TAP-seq paper