Name	Sequence
ADNP	TTGGGGCTGGAACGGAGCTA
AKIP1	AGTGCAGTGGCGTGATCTCG
ARID1A	CCTCCTCCCAGCTACCCCTT
ASF1B	TTTCTGGTGTCACAGGCGGG
ATP6V0A2	TGTGAACTTGAGTCAGTCCTATTGA
AUP1	TGCCTCCAAGGTGAGACCCA
B4GAT1	ACGGAACTGTTGGGAGGCTC
BAG3	GCAGTAACTTGGGTGGAGGCAA
BANF1	AGACACTTGTGGCGCCAACG
BTAF1	CCCAAAAAGGTGCCTGGTATTGG
BTBD3	TACACTGTAGATGCTTTTCCCCA
C12orf57	GGTGATCCAGGCGTTCTCCG
C19orf53	CCTCAAGGCATCCTCCCGC
C6orf62	GCTGCAGAAACCATGATAGGTAGAGG
CARNMT1	ATCACTGGAGGATTTATTTAGCTTTGT
CCDC85B	CTGCTGCGGGAGAACCTAGC
CDC37	CTACCACCGCCACCTGCTTC
CEBPB	GGGGAGCCCGTCGGTAATTT
CEP85	CCAGCCGTGCCTCCTCTAGA
CFL1	AATCCCTTCACCCCAGTTGCC
CLDN7	GTCTTGCCGCCTTGGTAGCT
CTNND1	CCCACCACCCCCTTTACTCG
DDX55	TGTCAGTATTTATCATGATGGGTCACA
DPM1	TGCTGAGACCAGGAGCATCTGA
DRAP1	AGAACGGTGGGATGGGAACG
EEF1D	AGGAGGAGGACAAGGAGGCG
EIF3G	GGGAAGTATGTGCCGCCGAG
EIF4A1	GCCAGGGCTCAATCTCTGGG
EIF5A	TCACCTAGCTCCCTTGGCCA
ELP5	TCCCTTCTCAGACAGCAGGCT
EMG1	TGGTGCCCAGCAGTGATCCTA
ENO2	TGGGCATGTGATCACGCCTG
ESCO1	CAACTTGGCACACCTAGGCTGT
ESF1	TTGTACTTAATTGTGGATGACTGACAA
FAM111A	AAGCACCCTCCCTCTAGGTCC
FAM122A	ACTTTGTGCAAGAAGTCCTAAAGTCA
FAM136A	ACTGGATTTGGGAAAACCTGGTT
FAM46B	CCTGATGGGCCAACTTGGGT
FAM64A	GCCTGCCATAGCCTGAGAGTG
FBXL12	AGGCCTAGGGACCTCCAGAC
FDX2	AGAGACGTGGAAGCCCCTGT
FEN1	ATTTCCTGGCTGGCCAACTGG
FEZF1	TCATCTTGGGTGGAGAGATGGTGT
FIBP	CCCCCAGCTTCTGTGCTCAG
FJX1	TCTCCCTTTGTTCCAGCGCC
FOXH1	CGACCACAGCAGCCTCGAAA
FUS	GCAACCAGTGTAAGGCCCCT
GABARAP	TGCCACAATGGGTCAGCTGT
GCFC2	AAGTGAATTCAGGGATGAAGTCGA
GEMIN4	TGCTCTGCACATCATGGCCA
GMCL1	GCCCATAGGTTCATAAATTGCTTTTGT
GPR18	TGGGAACGGGGGAGAACAGT
GPS2	GGACAGGTGGCCCACATCAT
GSK3B	ACTGTGTTCATGATTTGGTGTGGC
HERC4	TCTACGCTCTAAACTGATCCAAGCT
HMGA1	GCTTCCGCCACTCAGCCATT
HMGN2	TGGTTACCAGTGTGTCAGGCA
HNRNPM	CGTGCTGTACGCCGACATCA
HNRNPUL1	GGAGGGGGAGGAAGCAGTGA
HTRA2	GGGCACCGAGACAGAGGGTT
IER2	AATGTCCCGCGTCTCTGCAC
IGFBP2	ATGTCTCTGAACGGGCAGCG
KAT5	AGGACTGGAGCAAGAGGGGG
KAT8	CAGGCCTCTCATTCCTGGGC
KIFC2	CCCCCGCCAAGTGGTTACC
KYAT3	GCTGCCACCTGCTGGATGTTA
LARGE2	TCCTCGCTTTGTGGGCTTCG
LDOC1	CAGCTCACCAACCCCTGAAGG
LIN28A	TGCAATTGGGGGCCTTCCAT
LPCAT3	TGGGAATACAGGCACGCCAC
LRRC14	GTTGCGGGGGTCTTCCTCTC
LRRC24	ACTACTTGGACGGCCCCTGT
LRRC8B	TGAAGTGCTCTGTTCCCTAAGT
LRRC8D	GGAACTGCTTGGACCGCCTG
MAP1B	CCCCAAAACAGGAGCCATGGA
MDM2	CTTGCTCTGTGGCTCAGGCT
MED31	TGCTGGAAATCGACTTCGGT
MFSD3	AGCATGGACGCTGGCACAAT
MOGS	GGGGTGCTGTGTGGCTCAAT
MPDU1	TGGGGGTAGAGTCTCCCAAGC
MRI1	CGTGGCTGGTCTCCAACTCC
MRPL11	GCTCCATCATCGGGTCTGCC
MRPL19	ACACATGCCAAATGGACCAATGT
MRPL4	GTGGGTGGGGTGAGGAGAGA
MRPL53	AGTGATTGCGGACGTGAGGC
MRPS12	GCCAATCGCAAGTGCTGTCG
MRPS27	GGCTTCTCCATCGTGTTGGGG
MRS2	GGGCACACTTTTGGCACACC
NAMPT	TGGCTCTTAGTCACTTGGAACTGA
NANOG	CAGGAAAGTGGGGGAGAGCC
NDUFB7	GAGCTAGGTGACCCTCGGCT
NLGN2	GGACACAGTGGACGAGGGGA
P2RY11	CCACAGGACTGGAGACGCAAG
PCBP1	ATGTCCGGGGCCCAGATCAA
PEX10	GCACCTCCGTCGGAAGCATT
PHB2	CGCAAGATTCGAGCAGCCCA
PHKG2	AGGTCCTGCCCTTACGAAGCT
PKN2	AGCAAACTGTCCACTTCATTGGGA
PLPPR3	GCCAGCATCGTGACCATCGA
PLSCR3	CCACCACTGTCCCAGCAGTC
PMAIP1	TGCCGAAGATTACCGCTGGC
POLR2A	GGAGAACTGAGGGCACGTGG
POU5F1	TGTCCTTTCCTCTGGCCCCA
PPAN	GGCATGAAGAAGGCACGGGT
PPAN-P2RY11	GGCATGAAGAAGGCACGGGT
PRPF40A	CAGGGCACTGTAGGATGGATT
PRSS8	GGCCTGACTTGAGCCACTCC
PYCARD	CTCCTCAGTCGGCAGCCAAG
RBM14	TGTTCCTTCGCCTCAGCAGC
RBM14-RBM4	TCGTGGTACCCCATCTCCGG
RBM4	TCGTGGTACCCCATCTCCGG
RBM4B	TCTGTAGCCTTTCACTCTGTTCCT
RBMXL1	TGGCACTGTCATGTTTTAACATTTGCA
REPS1	GACGGGTGTCTTAGCTGCTGT
RER1	TGGCGCTTAAACCAAATCGCA
RIMKLB	TGGAGGGAAGGTCTTGGAGAAAC
RNASEH2C	AGCTGGGACCTTGGGAGTGT
RNASEK-C17orf49	AGGACGTTCCCTTCACGGAGA
RNF114	CCTCGCGCTTGTACACTGCT
RNF138	TGTGTGACCGTGATATAGTGAGAA
ROCK1	AAATGTAGAAGGTTGCACCAACA
RPA2	AAGCTCAGAGGGAGATGGGCA
RPAIN	GCACAGTGCACATTGTCCCC
RPL37A	GGCATGGCTCTTAAAGGATGCC
RPL8	CAGCTCACAGGGTGCAAGGG
RPS10	TCCCGAGGCTACGTGAAGGA
RPS10-NUDT3	GCCCTGGCCAGACGTTTTCT
RTKN	CAACCTCGCACTTGGCTCCA
S100A6	CCACAAGTACTCCGGCAGGG
SAC3D1	CCTACCTGCCAAGTTGCGCT
SALL4	GCACCTGAGCGGGGAATCTC
SAMD1	CTCCTCAGCACGTCGGTGTG
SAT2	GTGGGGCGACAAGTGAGGAC
SELENOH	TCGGCTCACTGCAACCATTGT
SENP3	TGCAGGGGGTGGCTACAGAA
SENP3-EIF4A1	ACTGACCTGCTGGCCAGAGG
SEPHS2	GGGATTTTTCTTTGCACGGGGT
SERF1A	TCTCATCTACGTGGCCCTGCT
SF1	GGATTCCCATCCGTCCTGGC
SF3B2	AAGGTGTGGAAGTGGCGCTG
SH3BGRL3	AGCTCTTCGTGGAGGCTGTG
SLC25A17	CCCTGAACTCTCCCCCAGGTT
SLC29A2	CCTGAGGGTGCTCAAAGGGC
SLC2A3	AATGCACGTAGCTGAGGCCG
SMAD4	TTGTCAGGCATGGCTCAGAGC
SMN1	ACTGGTTGGTTATGTGGAAGAAACA
SMPDL3B	TACTCTGCTGGGGTCTGCGA
SNRNP27	TATCTTCTGTGGTCGCCCGC
SNRPC	GCAGGGGCGATGATACCACC
SNRPG	AGCCCGCGGAGTATACACCA
SNX32	GCCAGCACCCTGATTCTCCG
SOX2	ATGGCCATGCAGGTTGACACC
SPSB2	GGCTACGCTATTGGGGGCAC
SRPK1	CGGCAGGGAAATCCTTCAGCAA
STX16	AAAGTGTCCGGGTGCAGCTC
SULT1A3	AGAGGGGCTCCTGGAGTCAC
SUZ12	CGAGCGTTTATCTCGGGCTTT
TAF11	CCCTCCCACCTCAGTCTCCT
TARDBP	ACTCAGCAGCAGTAACATGGT
TCF4	AGGTCGCAGCGGGGAAATTT
TDP2	TCTGCAGTTAAGTAGATGACAGCT
TECR	GGTCCTGGATCGGTTTCGCC
TIA1	GTGCATCTCATGGACTGCAGG
TM7SF2	GGCGGAAACTGCTGGTGTCT
TMEM107	TCGTCACCGTCTTTGGGCTG
TMEM167A	TCAAGTTCCTTTCACTGTGATTTGGA
TMEM256	GGTGCCCCATTGCAGAAAGC
TMEM88	ATTGCCTCGTGCCCTACAGC
TMX2-CTNND1	ATTCGGTGCCGCGACTTTCA
TNPO1	TGTGAGAAGAGATGTTTAAACGTGGT
TP53	TCACCCCATCCCACACCCTG
TPI1	CCTTGTGGGTGGTGCTTCCC
TRAPPC1	ACCCATCCGAGATGTGCTGC
TRIM27	CCCCAATGACTGCCCTACCC
TRNP1	ACCCCATCCCCAGCCAAGAA
TXNDC17	GTGCAGGCTGAACCAGTCGT
UBE2V1	GGTTGAACTTGGAGAAAGACCGC
UBL5	AGTCGGAGAAAGCTGTCGCG
VAMP2	TCACTGCCCAGCTCCTCTGA
VKORC1	TGGGCCTCTGTCCTGATGCT
VPS51	GGTGCTGACCGGCATCATCA
WBP1	GGCGACTCCGGTATTGAGCT
WDR54	ACCCTTGCAGAGTTCCGTGC
XRCC5	ACCTTTTGGCCCAATCTCTGC
YBX1	GAATTCGTCCGCTCCCGAGG
YIF1A	CGTTGGGGGTAGGGCCAATC
YIPF2	TGCCTGTGCTGCAACACGTT
YME1L1	TCACAGGAGCCACTGCACTC
ZFP91	CATGGCCGTGGGAGTACTGG
ZFP91-CNTF	AGGAAGGCCGAGTATCCCCG
ZKSCAN8	ACAAGCTCTTGCCTCTGTGCC
ZNF121	TGCCTACCTGTGTTCATTGCA
ZNF251	GAGAGAAGCACGGCAGAGCC
ZNF281	AACCACATTCATTCCAGCCTGGT
ZNF326	AGCTACCAGACTTAGATCCGATAAAT
ZNF414	CACGCCCGGTCTCCAGTTTT
ZNF43	AGGGTTGTAGTACCATTACTTGCA
ZNF532	CGACAAGCTACAGGGTGTTGC
ZNF593	GCCTGCGCGAGGTACTTCAT
ZNF785	TGATCCACCCGACTTGGCCT
ZNHIT2	CTCTGCGGAAGAAGCCCTGC
ZSCAN23	TCATTCTTCACCTGGTTCAAAAATCA
ZSCAN9	ACACAGGGGAGCGACCTCAC