Name	Sequence
ADNP	GTCTCGTGGGCTCGGAGATGTGTATAAGAGACAGTGTACAAGACACCACGGGGC
AKIP1	GTCTCGTGGGCTCGGAGATGTGTATAAGAGACAGGTGATCCACCCACCTTGGCC
ARID1A	GTCTCGTGGGCTCGGAGATGTGTATAAGAGACAGCTGTCTCAGCAGCCAATCAAC
ASF1B	GTCTCGTGGGCTCGGAGATGTGTATAAGAGACAGTGGTATCAGAGGGCCTGCCT
ATP6V0A2	GTCTCGTGGGCTCGGAGATGTGTATAAGAGACAGAGCTGAGAGTCTGGAGGTGCT
AUP1	GTCTCGTGGGCTCGGAGATGTGTATAAGAGACAGCCCTCAGCCAACAGCCCTAAC
B4GAT1	GTCTCGTGGGCTCGGAGATGTGTATAAGAGACAGTGGGTGGGTAGTAGGAGAGCA
BAG3	GTCTCGTGGGCTCGGAGATGTGTATAAGAGACAGGTAGCTCTGGACTGGAGGGGT
BANF1	GTCTCGTGGGCTCGGAGATGTGTATAAGAGACAGTCACCTCCGACGTACTCCGG
BTAF1	GTCTCGTGGGCTCGGAGATGTGTATAAGAGACAGATCCCCAAGGTTTGTGGCTGG
BTBD3	GTCTCGTGGGCTCGGAGATGTGTATAAGAGACAGAGGCTAGCAGTTCTAATGTGACA
C12orf57	GTCTCGTGGGCTCGGAGATGTGTATAAGAGACAGTCCTGAGATCGCCAGCCTGT
C19orf53	GTCTCGTGGGCTCGGAGATGTGTATAAGAGACAGAGTGCAGGCCAACATCCCAC
C6orf62	GTCTCGTGGGCTCGGAGATGTGTATAAGAGACAGAGCAGAACTCATTTTGTGCAATGA
CARNMT1	GTCTCGTGGGCTCGGAGATGTGTATAAGAGACAGTCAAGTGAGCAAGGTGGAACATGT
CCDC85B	GTCTCGTGGGCTCGGAGATGTGTATAAGAGACAGGTCCGGATCAGTTGCCCCTG
CDC37	GTCTCGTGGGCTCGGAGATGTGTATAAGAGACAGCTGTCTCCACTCTCCAGCGC
CEBPB	GTCTCGTGGGCTCGGAGATGTGTATAAGAGACAGGACTGACGCAACCCACGTGT
CEP85	GTCTCGTGGGCTCGGAGATGTGTATAAGAGACAGCTTGGACCTCATGCCTGGGC
CFL1	GTCTCGTGGGCTCGGAGATGTGTATAAGAGACAGATCCCCATTCCCCACCTGGT
CLDN7	GTCTCGTGGGCTCGGAGATGTGTATAAGAGACAGATCTCCTTGCCCCAGCCTGA
CTNND1	GTCTCGTGGGCTCGGAGATGTGTATAAGAGACAGTCTCGGTGGGGTGTGGGTAAT
DDX55	GTCTCGTGGGCTCGGAGATGTGTATAAGAGACAGGGGTGGCTAATGTGCTGGGG
DPM1	GTCTCGTGGGCTCGGAGATGTGTATAAGAGACAGTGGTGAATCCAAGTTGGGAGGAA
DRAP1	GTCTCGTGGGCTCGGAGATGTGTATAAGAGACAGCGACTCCTAGCGCCTTCTGC
EEF1D	GTCTCGTGGGCTCGGAGATGTGTATAAGAGACAGAGGCCTGTGTGCGCTCTATC
EIF3G	GTCTCGTGGGCTCGGAGATGTGTATAAGAGACAGGGAGCTCTTCCGGCCTTTCG
EIF4A1	GTCTCGTGGGCTCGGAGATGTGTATAAGAGACAGTCCTCACCTCAGCTGAGCTCC
EIF5A	GTCTCGTGGGCTCGGAGATGTGTATAAGAGACAGTACCCTGAGCACCACCCCAA
ELP5	GTCTCGTGGGCTCGGAGATGTGTATAAGAGACAGCTATGGAGCCCCGCCTTGTG
EMG1	GTCTCGTGGGCTCGGAGATGTGTATAAGAGACAGGGACTGCTTGGCTCGGTCAT
ENO2	GTCTCGTGGGCTCGGAGATGTGTATAAGAGACAGAAGCCTGCGTTGGTCCAGAG
ESCO1	GTCTCGTGGGCTCGGAGATGTGTATAAGAGACAGTGCTGTGGCCTTTTATGACCTGT
ESF1	GTCTCGTGGGCTCGGAGATGTGTATAAGAGACAGTAATTTCTCTGGAAGCAGGAGGC
FAM111A	GTCTCGTGGGCTCGGAGATGTGTATAAGAGACAGGCTGGCATGATGACTGCTGTTTG
FAM122A	GTCTCGTGGGCTCGGAGATGTGTATAAGAGACAGGGCTGCTGGATGTTAGGACCC
FAM136A	GTCTCGTGGGCTCGGAGATGTGTATAAGAGACAGGAGCAAAGGAGAGACAGCCCC
FAM46B	GTCTCGTGGGCTCGGAGATGTGTATAAGAGACAGAGGGGTTGAGGTGGGCAGTA
FAM64A	GTCTCGTGGGCTCGGAGATGTGTATAAGAGACAGGCTTACGACCCTGGGCTCAC
FBXL12	GTCTCGTGGGCTCGGAGATGTGTATAAGAGACAGTGCATGCACACCCACAAGCC
FDX2	GTCTCGTGGGCTCGGAGATGTGTATAAGAGACAGAGGCCCCAGCATGTTGAGTG
FEN1	GTCTCGTGGGCTCGGAGATGTGTATAAGAGACAGCCACCAGGAAGGCGCATCTT
FEZF1	GTCTCGTGGGCTCGGAGATGTGTATAAGAGACAGCGGTCTCAAGATGTCTGCTGGA
FIBP	GTCTCGTGGGCTCGGAGATGTGTATAAGAGACAGTCTCTTGGGCCCGCAGTTTG
FJX1	GTCTCGTGGGCTCGGAGATGTGTATAAGAGACAGCCCTCTCGCAACCGACCAAA
FOXH1	GTCTCGTGGGCTCGGAGATGTGTATAAGAGACAGACCCTCACCCTGGTCTGTCA
FUS	GTCTCGTGGGCTCGGAGATGTGTATAAGAGACAGATCGCAGGGAGAGGCCGTAT
GABARAP	GTCTCGTGGGCTCGGAGATGTGTATAAGAGACAGCTCTGCCCGCCTTTCCCATC
GCFC2	GTCTCGTGGGCTCGGAGATGTGTATAAGAGACAGAGAAGCTGGTGCCTCTCTCTTCT
GEMIN4	GTCTCGTGGGCTCGGAGATGTGTATAAGAGACAGCTGAAGAACGGCGCCAAACC
GMCL1	GTCTCGTGGGCTCGGAGATGTGTATAAGAGACAGCCGAGGCAGGCAGATCATCTG
GPR18	GTCTCGTGGGCTCGGAGATGTGTATAAGAGACAGTCCGATCTGGTAGTCTACGGTCA
GPS2	GTCTCGTGGGCTCGGAGATGTGTATAAGAGACAGACAGCCAGAACCCGCGATTC
GSK3B	GTCTCGTGGGCTCGGAGATGTGTATAAGAGACAGCCTCCCAGGTAACCAACACATGT
HERC4	GTCTCGTGGGCTCGGAGATGTGTATAAGAGACAGTCTACGAGTGTTCATGGAAGCCA
HMGA1	GTCTCGTGGGCTCGGAGATGTGTATAAGAGACAGCCTGTTCTGCCCACGATCCC
HMGN2	GTCTCGTGGGCTCGGAGATGTGTATAAGAGACAGACTGTTAACGATTGTCTGCCCATGT
HNRNPM	GTCTCGTGGGCTCGGAGATGTGTATAAGAGACAGAGCCTGCCGGATGATGAATGG
HNRNPUL1	GTCTCGTGGGCTCGGAGATGTGTATAAGAGACAGACGATGCCCCAGTTCCCCATA
HTRA2	GTCTCGTGGGCTCGGAGATGTGTATAAGAGACAGTGAGGTGGGAGGGCTGGATC
IER2	GTCTCGTGGGCTCGGAGATGTGTATAAGAGACAGGGGGGTGTCAGTGGAAAGGC
IGFBP2	GTCTCGTGGGCTCGGAGATGTGTATAAGAGACAGCCCTCTCCAAACACCGGCAG
KAT5	GTCTCGTGGGCTCGGAGATGTGTATAAGAGACAGAAGGGATCCGGATGGGGGAG
KAT8	GTCTCGTGGGCTCGGAGATGTGTATAAGAGACAGCACAGTGGACTCCGTCTGCC
KIFC2	GTCTCGTGGGCTCGGAGATGTGTATAAGAGACAGAGGTGACGGCTGGTGACTGA
KYAT3	GTCTCGTGGGCTCGGAGATGTGTATAAGAGACAGACCTCTCAGTAACTCGGTTCTCTCA
LARGE2	GTCTCGTGGGCTCGGAGATGTGTATAAGAGACAGGGACTTGTCCCGCCACCATG
LDOC1	GTCTCGTGGGCTCGGAGATGTGTATAAGAGACAGTGCAGCAGTCCCACAGATGTG
LIN28A	GTCTCGTGGGCTCGGAGATGTGTATAAGAGACAGTTATGGGGCGGGAGGGTAGG
LPCAT3	GTCTCGTGGGCTCGGAGATGTGTATAAGAGACAGTCCCCCATGCACATTGCCTT
LRRC14	GTCTCGTGGGCTCGGAGATGTGTATAAGAGACAGCTCCACCGTGGCGCTGTAG
LRRC24	GTCTCGTGGGCTCGGAGATGTGTATAAGAGACAGGAGATCCACTGCTAGGGCCG
LRRC8B	GTCTCGTGGGCTCGGAGATGTGTATAAGAGACAGTCAGGGTACATCTGTGTGGCAC
LRRC8D	GTCTCGTGGGCTCGGAGATGTGTATAAGAGACAGTGCAAGTGCTCACGTACAAGT
MAP1B	GTCTCGTGGGCTCGGAGATGTGTATAAGAGACAGGCAGCCCCTCTTTCCAGCAC
MDM2	GTCTCGTGGGCTCGGAGATGTGTATAAGAGACAGCCAGGCTGGGCTCAAACTCC
MED31	GTCTCGTGGGCTCGGAGATGTGTATAAGAGACAGTCAGCAAGCCTTGGCAGAGC
MFSD3	GTCTCGTGGGCTCGGAGATGTGTATAAGAGACAGGGCCTGGTCACCACAGTCAC
MOGS	GTCTCGTGGGCTCGGAGATGTGTATAAGAGACAGGGAGCAGTACAGTGACCGCG
MPDU1	GTCTCGTGGGCTCGGAGATGTGTATAAGAGACAGAGTCTGGACGGCAGAGTGGA
MRI1	GTCTCGTGGGCTCGGAGATGTGTATAAGAGACAGAGAGGCTAGAACCCCGCACT
MRPL11	GTCTCGTGGGCTCGGAGATGTGTATAAGAGACAGGACCCTTGCCCCACCAACTC
MRPL19	GTCTCGTGGGCTCGGAGATGTGTATAAGAGACAGACATTCATGTACCCACTATCAGGT
MRPL4	GTCTCGTGGGCTCGGAGATGTGTATAAGAGACAGCTTCAGCCTGCCCTACAGCG
MRPL53	GTCTCGTGGGCTCGGAGATGTGTATAAGAGACAGGAAATGCTCACCGCCTTCGC
MRPS12	GTCTCGTGGGCTCGGAGATGTGTATAAGAGACAGGTCCTCCGATGCTGGCCTTT
MRPS27	GTCTCGTGGGCTCGGAGATGTGTATAAGAGACAGATGGGTTGGGGCTTGAAGTGC
MRS2	GTCTCGTGGGCTCGGAGATGTGTATAAGAGACAGAGGGCAACATTTGATTTGACTAAGA
NAMPT	GTCTCGTGGGCTCGGAGATGTGTATAAGAGACAGAACTCTGCTGTGTGTCACCCT
NANOG	GTCTCGTGGGCTCGGAGATGTGTATAAGAGACAGAGCTGCTGGTGGTGAGTCTC
NDUFB7	GTCTCGTGGGCTCGGAGATGTGTATAAGAGACAGGCTGCTCAAGTGCAAGCGTG
NLGN2	GTCTCGTGGGCTCGGAGATGTGTATAAGAGACAGTCCCCTGCCTGGTCTAGCTC
P2RY11	GTCTCGTGGGCTCGGAGATGTGTATAAGAGACAGTGGGCAGAGGACGGGGTAAT
PCBP1	GTCTCGTGGGCTCGGAGATGTGTATAAGAGACAGGCTGTTCTCCCATGATCCAACTGT
PEX10	GTCTCGTGGGCTCGGAGATGTGTATAAGAGACAGCCAGCCTATTTCCCGCCTCC
PHB2	GTCTCGTGGGCTCGGAGATGTGTATAAGAGACAGCCCACACCGGTTCCCTGAAC
PHKG2	GTCTCGTGGGCTCGGAGATGTGTATAAGAGACAGATGGTCACTTGTGCCAGGCC
PKN2	GTCTCGTGGGCTCGGAGATGTGTATAAGAGACAGTGTTGATGAATGAAGAACAGCCTGT
PLPPR3	GTCTCGTGGGCTCGGAGATGTGTATAAGAGACAGGTCAGCGACGTGGACCAGG
PLSCR3	GTCTCGTGGGCTCGGAGATGTGTATAAGAGACAGACCATGGCACTTTGAGGGGG
PMAIP1	GTCTCGTGGGCTCGGAGATGTGTATAAGAGACAGTGCTTTTCAGTGCCAACTCAGCA
POLR2A	GTCTCGTGGGCTCGGAGATGTGTATAAGAGACAGTGGCCCAGTGGTGTTCTCAC
POU5F1	GTCTCGTGGGCTCGGAGATGTGTATAAGAGACAGTTCCCCCTGTCTCCGTCACC
PPAN	GTCTCGTGGGCTCGGAGATGTGTATAAGAGACAGCGGAAGCGGTGGGAAATGGA
PPAN-P2RY11	GTCTCGTGGGCTCGGAGATGTGTATAAGAGACAGGAGGCCAAGCAGAAACGGCT
PRPF40A	GTCTCGTGGGCTCGGAGATGTGTATAAGAGACAGGGTGGTTTTGCTGGAAACTTGGT
PRSS8	GTCTCGTGGGCTCGGAGATGTGTATAAGAGACAGGCTCCTGGGACCCTTGGCTA
PYCARD	GTCTCGTGGGCTCGGAGATGTGTATAAGAGACAGACGGGAAGGTCCTGACGGAT
RBM14	GTCTCGTGGGCTCGGAGATGTGTATAAGAGACAGGTGCCAGCAGTCCAGGGTAC
RBM14-RBM4	GTCTCGTGGGCTCGGAGATGTGTATAAGAGACAGCCCAGCAGGCCTCATTGTGT
RBM4	GTCTCGTGGGCTCGGAGATGTGTATAAGAGACAGCCCAGCAGGCCTCATTGTGT
RBM4B	GTCTCGTGGGCTCGGAGATGTGTATAAGAGACAGTCCTTCTCCCTGCCTACCTGC
RBMXL1	GTCTCGTGGGCTCGGAGATGTGTATAAGAGACAGGTGAGGACCTTTTGGCTCTTAAGA
REPS1	GTCTCGTGGGCTCGGAGATGTGTATAAGAGACAGGCCAATTGCCGTTAACTGTGAACA
RER1	GTCTCGTGGGCTCGGAGATGTGTATAAGAGACAGAGCCTGATTCCTGCGTGTCC
RIMKLB	GTCTCGTGGGCTCGGAGATGTGTATAAGAGACAGACCAAGTGAAGCAAGGGGGAC
RNASEH2C	GTCTCGTGGGCTCGGAGATGTGTATAAGAGACAGCTCGTGCTGATAGCTGGCCG
RNASEK-C17orf49	GTCTCGTGGGCTCGGAGATGTGTATAAGAGACAGAGACTCCCTGCACCGTGTCA
RNF114	GTCTCGTGGGCTCGGAGATGTGTATAAGAGACAGAGTCTGGAGGGAAATCTGGCG
RNF138	GTCTCGTGGGCTCGGAGATGTGTATAAGAGACAGAGAGTGGATTTGCTGACATTCCA
ROCK1	GTCTCGTGGGCTCGGAGATGTGTATAAGAGACAGAGAAGCACTGGAAAACCGATCGT
RPA2	GTCTCGTGGGCTCGGAGATGTGTATAAGAGACAGGCCCTAGCCGAGAAACCTGC
RPAIN	GTCTCGTGGGCTCGGAGATGTGTATAAGAGACAGTGTGACGCAGGTTGAAGGGG
RPL37A	GTCTCGTGGGCTCGGAGATGTGTATAAGAGACAGAGTACCACTTCCGCTGTCACG
RPL8	GTCTCGTGGGCTCGGAGATGTGTATAAGAGACAGGGCCGGGCGTACCACAAATA
RPS10	GTCTCGTGGGCTCGGAGATGTGTATAAGAGACAGGCGACCTGCGAGACTCACAA
RPS10-NUDT3	GTCTCGTGGGCTCGGAGATGTGTATAAGAGACAGTGGGCATTTCTAGAATTGAGAGCCT
RTKN	GTCTCGTGGGCTCGGAGATGTGTATAAGAGACAGGGTTGCCATGGTACCGAGGG
S100A6	GTCTCGTGGGCTCGGAGATGTGTATAAGAGACAGACCATTGGCTCGAAGCTGCA
SAC3D1	GTCTCGTGGGCTCGGAGATGTGTATAAGAGACAGCTACCGCCTGCCAGTACGTG
SALL4	GTCTCGTGGGCTCGGAGATGTGTATAAGAGACAGAGGCACGTCCTGGGTGTGA
SAMD1	GTCTCGTGGGCTCGGAGATGTGTATAAGAGACAGAGGGGACTAGCTGGGTTGGG
SAT2	GTCTCGTGGGCTCGGAGATGTGTATAAGAGACAGGTTGGCAGGAAAGTGACGCC
SELENOH	GTCTCGTGGGCTCGGAGATGTGTATAAGAGACAGGCCTGCCTTGACCTCCCAAA
SENP3	GTCTCGTGGGCTCGGAGATGTGTATAAGAGACAGGGGTGGTGGGCGGACAATAG
SENP3-EIF4A1	GTCTCGTGGGCTCGGAGATGTGTATAAGAGACAGAATCGGTCGAGGTGGACGGT
SEPHS2	GTCTCGTGGGCTCGGAGATGTGTATAAGAGACAGGGCTCTTTCCTGCTCTGGACA
SERF1A	GTCTCGTGGGCTCGGAGATGTGTATAAGAGACAGTGCCTGTGACAGTTGGCCTC
SF1	GTCTCGTGGGCTCGGAGATGTGTATAAGAGACAGTCCTTCCTTTTTCCTCCCGCT
SF3B2	GTCTCGTGGGCTCGGAGATGTGTATAAGAGACAGAGGTCCCCTCACACTAGCCC
SH3BGRL3	GTCTCGTGGGCTCGGAGATGTGTATAAGAGACAGAGGCCACTTCTCCTCCCTCC
SLC25A17	GTCTCGTGGGCTCGGAGATGTGTATAAGAGACAGCTCAGTGTTGGTGTTTTCCTCCCT
SLC29A2	GTCTCGTGGGCTCGGAGATGTGTATAAGAGACAGTGGTAGAGCCGGGACCCAAT
SLC2A3	GTCTCGTGGGCTCGGAGATGTGTATAAGAGACAGATTGCACTCTAGCCTGGGCC
SMAD4	GTCTCGTGGGCTCGGAGATGTGTATAAGAGACAGTGCTGATTTTAAAGGCAGAGAAGTT
SMN1	GTCTCGTGGGCTCGGAGATGTGTATAAGAGACAGTGGAATTCGTCAAGCCTCTGGT
SMPDL3B	GTCTCGTGGGCTCGGAGATGTGTATAAGAGACAGAGAGCTGGGCCTTCCACCAT
SNRNP27	GTCTCGTGGGCTCGGAGATGTGTATAAGAGACAGTTGATCCCACCTATGAGATCAGAAT
SNRPC	GTCTCGTGGGCTCGGAGATGTGTATAAGAGACAGGCCCGGAATGACTCGACCAG
SNRPG	GTCTCGTGGGCTCGGAGATGTGTATAAGAGACAGGTCCTCTCTCCATAGGGCCTGT
SNX32	GTCTCGTGGGCTCGGAGATGTGTATAAGAGACAGCAGGGCAGCATGGGCATCAT
SOX2	GTCTCGTGGGCTCGGAGATGTGTATAAGAGACAGTCAGTCTGCCGAGAATCCATGT
SPSB2	GTCTCGTGGGCTCGGAGATGTGTATAAGAGACAGGCCATGAAGCGCTACCTGCT
SRPK1	GTCTCGTGGGCTCGGAGATGTGTATAAGAGACAGTGCTTCTCCACCAAATAAGGGCT
STX16	GTCTCGTGGGCTCGGAGATGTGTATAAGAGACAGGCTGGGCCATGCTTGTGAAG
SULT1A3	GTCTCGTGGGCTCGGAGATGTGTATAAGAGACAGTGGGAGGTTGAGCTGGTAGGA
SUZ12	GTCTCGTGGGCTCGGAGATGTGTATAAGAGACAGTGCACAAAAAGTTGGTGATTCCCA
TAF11	GTCTCGTGGGCTCGGAGATGTGTATAAGAGACAGGCTGGTCGTGAACTCCTGGC
TARDBP	GTCTCGTGGGCTCGGAGATGTGTATAAGAGACAGAGGCTTTCAATGTTGAGTGGCCT
TCF4	GTCTCGTGGGCTCGGAGATGTGTATAAGAGACAGCCCAGCTTGGTCAAGGCCATT
TDP2	GTCTCGTGGGCTCGGAGATGTGTATAAGAGACAGTCGGTTTGATAGCACCATGGG
TECR	GTCTCGTGGGCTCGGAGATGTGTATAAGAGACAGCAAGCACCGCAGCTACCTGA
TIA1	GTCTCGTGGGCTCGGAGATGTGTATAAGAGACAGTCAGGAACACCTCTATCTTTGGTT
TM7SF2	GTCTCGTGGGCTCGGAGATGTGTATAAGAGACAGCCTGCAGAAGTACGGCCTGG
TMEM107	GTCTCGTGGGCTCGGAGATGTGTATAAGAGACAGTCCCCTCGGAAACTGCTTCTG
TMEM167A	GTCTCGTGGGCTCGGAGATGTGTATAAGAGACAGTGCTTTTCCTCTGGGCACACC
TMEM256	GTCTCGTGGGCTCGGAGATGTGTATAAGAGACAGGGCTCTGAGTGGAGACCCCA
TMEM88	GTCTCGTGGGCTCGGAGATGTGTATAAGAGACAGCCCCACATCCCGGAAAACCC
TMX2-CTNND1	GTCTCGTGGGCTCGGAGATGTGTATAAGAGACAGTTCCTCCTTGCTGTGGTGGC
TNPO1	GTCTCGTGGGCTCGGAGATGTGTATAAGAGACAGTGTTTCCTGTACCTGCCACAC
TP53	GTCTCGTGGGCTCGGAGATGTGTATAAGAGACAGGGGGTCTCACAGTGTTGCCC
TPI1	GTCTCGTGGGCTCGGAGATGTGTATAAGAGACAGGGTTGGGACCAGGCCAATCC
TRAPPC1	GTCTCGTGGGCTCGGAGATGTGTATAAGAGACAGCCCTTCCGAACCTGTGCCAA
TRIM27	GTCTCGTGGGCTCGGAGATGTGTATAAGAGACAGGCAGCTCCTCTGATCATCTGCC
TRNP1	GTCTCGTGGGCTCGGAGATGTGTATAAGAGACAGTGCCCTTGTTCTCCACGTGG
TXNDC17	GTCTCGTGGGCTCGGAGATGTGTATAAGAGACAGGGCCAACCTGGTGGAAATGTT
UBE2V1	GTCTCGTGGGCTCGGAGATGTGTATAAGAGACAGAAGGAACCCGGTGTGCACAG
UBL5	GTCTCGTGGGCTCGGAGATGTGTATAAGAGACAGGACCACGTGTCTCTGGGGGA
VAMP2	GTCTCGTGGGCTCGGAGATGTGTATAAGAGACAGTCCCTTAACCTGCCACGGGA
VKORC1	GTCTCGTGGGCTCGGAGATGTGTATAAGAGACAGCCAGGGCAAGGCTAAGAGGC
VPS51	GTCTCGTGGGCTCGGAGATGTGTATAAGAGACAGGCGTTTTGTGGCCGACGAAG
WBP1	GTCTCGTGGGCTCGGAGATGTGTATAAGAGACAGCCCCCAGAGTCTGTACCGCA
WDR54	GTCTCGTGGGCTCGGAGATGTGTATAAGAGACAGAGATCAATGCCCATGCCCGG
XRCC5	GTCTCGTGGGCTCGGAGATGTGTATAAGAGACAGACCTCTGTCTTCAGCACCCTCA
YBX1	GTCTCGTGGGCTCGGAGATGTGTATAAGAGACAGAGTGCTTGCTTTTTGCCCGTT
YIF1A	GTCTCGTGGGCTCGGAGATGTGTATAAGAGACAGCTTCCAGGTGCGCTCTTTGC
YIPF2	GTCTCGTGGGCTCGGAGATGTGTATAAGAGACAGCGCCTTCCGTGACAGATCCT
YME1L1	GTCTCGTGGGCTCGGAGATGTGTATAAGAGACAGACCCTGCGTCAGAAATGCCA
ZFP91	GTCTCGTGGGCTCGGAGATGTGTATAAGAGACAGTCCTTTGTACCTGTTTGGGGAAAA
ZFP91-CNTF	GTCTCGTGGGCTCGGAGATGTGTATAAGAGACAGCCGGGGCTGGCGTAGTAGTA
ZKSCAN8	GTCTCGTGGGCTCGGAGATGTGTATAAGAGACAGACCTCATGCGATGACCTCCCT
ZNF121	GTCTCGTGGGCTCGGAGATGTGTATAAGAGACAGACTGCGGTATTTGCCACAAGC
ZNF251	GTCTCGTGGGCTCGGAGATGTGTATAAGAGACAGCACCACCTCAGCAGACTCGTG
ZNF281	GTCTCGTGGGCTCGGAGATGTGTATAAGAGACAGACGGTTCTGTCTGCGCTGTT
ZNF326	GTCTCGTGGGCTCGGAGATGTGTATAAGAGACAGAATGCTGCTCTTGGGAGTGAA
ZNF414	GTCTCGTGGGCTCGGAGATGTGTATAAGAGACAGGTGGCGCACACCTGTAGTCC
ZNF43	GTCTCGTGGGCTCGGAGATGTGTATAAGAGACAGACATGAGGGTCTATAATGCTTGGT
ZNF532	GTCTCGTGGGCTCGGAGATGTGTATAAGAGACAGTGGTAGGCCACATAGGTCCGA
ZNF593	GTCTCGTGGGCTCGGAGATGTGTATAAGAGACAGTGAAGCAGCTGAGCGTCGAG
ZNF785	GTCTCGTGGGCTCGGAGATGTGTATAAGAGACAGAGTTATGAAGGCCAGGCGCG
ZNHIT2	GTCTCGTGGGCTCGGAGATGTGTATAAGAGACAGCCTGGCCTGGACCAACGAAA
ZSCAN23	GTCTCGTGGGCTCGGAGATGTGTATAAGAGACAGTCCATTACTCAGGAAGATGGCAT
ZSCAN9	GTCTCGTGGGCTCGGAGATGTGTATAAGAGACAGTGTGTGGGGCAGGTTGAGAC