gene	sequence	type
ATP6V1C1	TCCTCCCCCGACAATCCTGT	TAP-control-outer
AZIN1	GCCCCAATCCATTGCCATCAA	TAP-control-outer
CCNE2	TCAACTCTGTCTGGCCGATGG	TAP-control-outer
COPB1	GGCAGCCAACCTTTATGCTCG	TAP-control-outer
CTR9	AGAGGCTCAGAACATGGGTCAG	TAP-control-outer
EBAG9	CAGCTCCACAACCCAAGCAAC	TAP-control-outer
EIF3F	CAGCTAAGGCACCCCTAGTCT	TAP-control-outer
EMC2	TGGAAACATTGCAGATCACCCA	TAP-control-outer
GTF2H1	TCCAAGTTACGAAGCTCTGTCCA	TAP-control-outer
HBD	GGGCAGAGTCGACTGTTGCT	TAP-control-outer
HTATIP2	ATCCATGACCTGGGGAAAGCG	TAP-control-outer
ILK	TGTGGGAACTGGTGACACGG	TAP-control-outer
INTS8	TTGCTGAATTGCCACACACAG	TAP-control-outer
MRPL17	CTAACGAACGAGCCATGCGC	TAP-control-outer
MTDH	AGATGTTTCACCATTTTCAGGCACT	TAP-control-outer
NAP1L4	ACCAGGGCTGAAGATGCGAG	TAP-control-outer
NSMCE2	TGAGTCCAGGCAAAAGCGGA	TAP-control-outer
NUDCD1	TGTGAGTGCCTTCGTCGAGT	TAP-control-outer
ACP5	GCCCGATCTCCACTGTTGGG	Cell-state-outer
ASCL2	ACTGAGCGCCCTCGACCTAT	Cell-state-outer
CA1	CAGCACAACAACCGCCCAAC	Cell-state-outer
CCNB1	AGCAGAGGAAGCATGAGAGCAC	Cell-state-outer
CCNB2	TGGCTTCAGCGATTGGGCAT	Cell-state-outer
CD320	GCTCAGTGCAAGCCTGGTCA	Cell-state-outer
CDC20	TGTCTGAGTGCCGTGGATGC	Cell-state-outer
CDKN3	GGGACTCCTGACATAGCCAGC	Cell-state-outer
DDIT3	GGAAATCGAGCGCCTGACCA	Cell-state-outer
HRAS	ATGCGGGACCAGTACATGCG	Cell-state-outer
NQO2	GGCACGGCCGAGATGTACAC	Cell-state-outer
PNRC1	CAGGGAGCTGATGGCAGTACAC	Cell-state-outer
PPP1R15A	TGGCAATCCCCCATACCCCT	Cell-state-outer
SAT1	AATGAGGTGTCGCTGCAGCA	Cell-state-outer
STX3	GCAGGGCTGAGTCAGTTGGG	Cell-state-outer
WDR77	AGGAATTGGCCGTGTCTGGG	Cell-state-outer
ANAPC11_O	GCATGTCCGGTGTCCCTTGG	P2-outer
ATF2_O	TCTAAGGAGTTATCTCAAAGGCACA	P2-outer
BUB1B_O	TTGGGGAGCTTGCAGCAGAA	P2-outer
CFL1_O	CCCTTCACCCCAGTTGCCAA	P2-outer
EYA3_O	AAAATCTAGTTCTGCCTCAGCCCC	P2-outer
FKBP2_O	GGGGAATGGGCTTGGGAGTG	P2-outer
GPBP1_O	GGAAATGGGCTGGCAGGAAGA	P2-outer
HSP90B1_O	AGAGCTATGAGAGTGCATGATTCCA	P2-outer
HSPA5_O	AGTTGCTGCTCCTTGTAGACCAA	P2-outer
KNOP1_O	ACAGCCTTCTCGGTCCAGGA	P2-outer
MKRN1_O	AACACAAACTGGGTCTTGGATACACA	P2-outer
MRPL17_O	TAACGAACGAGCCATGCGCA	P2-outer
MRPS25_O	CGGCCCTCGAAAGTACTGCC	P2-outer
NOSIP_O	CCGTGCACTTCACACCGCTA	P2-outer
NUP43_O	GCGTGGTGGCAGGCATCTAT	P2-outer
ZNF317_O	AGTGACTTCCCCGGTATCCACT	P2-outer
MYC_TAP_outer	CACACAACGTCTTGGAGCGC	MYC outer primer from TAP-seq paper